[Tic Tac Toe Text Resources]
LanguageName=Čeština
TicTacToe=Piškvorky
NewGame=Nová hra
Size=Velikost
PlayerO=Hráč O
PlayerX=Hráč X
Computer=Počítač
Human=Člověk
Starts=Začíná
Random=Náhodně
Opening=Zahájení
Classic=Klasické
Swap1=Swap 1
Swap2=Swap 2
Start=Start
GameSettings=Nastavení hry
CompODeffensive=Počítač O defenzíva
CompXDeffensive=Počítač X defenzíva
MoveDuration=Délka tahu
Localization=Lokalizace
About=O aplikaci
CreatedByMichalMarsalekIn2015=Vytvořil Michal Maršálek v roce 2015.
GameIsInProgress=Hra probíhá
OWon=O vyhrál
XWon=X vyhrál
ItsDraw=Je to remíza
DoYouWantToCloseTheGame=Chceš hru zavřít?
GameOver=Konec hry.
YourGameIsInProgressDoYouReallyWantToQuit=Máš rozehranou hru, vážně chcete skončit?
QuitTheGame=Konec hry?
ItsOTurn=Na řadě je O
ItsXTurn=Na řadě je X
PressEscToPassTheTurnToYourOpponent=Zmáčkni ESC abys předal tah svému soupeři.